com.xczaixian.www	西昌 西昌 androi d版 凉山州 西昌 聊天 交流 社区 汇聚 凉山 西昌 资讯 西昌 招聘 求职 西昌 房屋 租售 西昌 生活 西昌 商务 西昌 购物 西昌 娱乐 综合型 聊天 社交 社区 餐厅 生活服务 聊天社交 社区 餐厅推荐
da.gong.shenghuo	兼职 对象 兼职 打零工 工的 兼职 工作时间 开工 收工 工作时间 兼职 工作 工作时间 工资 报酬 工资 工作 开工 按钮 工作 收工 按钮 调薪 补录 效率 办公 效率办公
com.kstapp.xiangyuebaihe	百合 采购 麻烦 个性 如梦 婚典 百合 专业 婚礼 顾问 摄影师 团队 总监 灯光 舞美 音乐 专业 婚礼 婚事 企划 团队 新人 量身 浪漫 婚礼 回味 一生 丽人 母婴 美容 美妆 丽人母婴 美容·美妆
com.extreamsd.aemobile	音频编辑 audioevolutionmobile 多轨 音频 非线性 混音 实时 平板 分辨率 ae5forwindows osx 组合 多轨 音频 回放 音频 录制 回放 音轨 wav aiff flac ogg vorbis 音频文件 mp3 专利 国家 扩展 立体声 文件 做母 音轨 音量 声像 静音 独奏 均衡 音频 总线 音轨 实时 合唱 混响 带通 高通 低通 镶边 噪声 颤音 非线性 破坏性 修剪 分离 剪切 粘贴 移除 工具 采样 网格 标记 采样 loop 标记 跳转 工程 audioevolution5 工程 缓冲 作者 extreamsoftwaredevelopment 英文 音乐 剪辑 音乐 影音视听 剪辑
com.klabjan.movethematchespuzzles	火柴 谜题 火柴 谜题 matchespuzzl e通 移走 火柴 谜题 解法 猜猜看 休闲益智
com.SmartBomb.AJJump	袋鼠 跳跳 袋鼠 跳跳 ajjump animaljamkangaroos 纸片 卡通画 玩法 动作游戏 操控 俏皮 可爱 袋鼠 动物 添乱 家伙 蜘蛛 高分 躲避 机关 道具 弹簧 蹦床 火箭 飞行 背包 作者 smartbombinteractive 英文 3d 跳跃 躲避 动作冒险 躲避 3d 跳跃
com.dengsoft.phonenumberregions	归属 归属 自带 归属 数据库 联网 拖动 极小 资源 开机 自启动 电时 归属 作者 优思 工作室 中文 内容 号码 归属 电话区号 运行 初始化 数据 进度 对话框 颜色 归属 自带 归属 数据库 联网 拖动 极小 资源 开机 自启动 电时 归属 通讯 社交通讯 通讯社交
com.talkingtomfour.livewallpaperil	汤姆 壁纸 美化版 休闲游戏 汤姆 冒险 旅程 汤姆 宠物猫 触摸 作出反应 滑稽 声音 汤姆 国际 名人 搬出 小巷 漂亮 公寓 汤姆 一帆风顺 邻居 戏弄 取笑 汤姆 中文版 杀人放火 居家 旅行 本款 diy 壁纸 作品 作品 领先 图形 引擎 驱动 绿色 小巧 动感 耗电 美化 桌面 朋友 壁纸 壁纸 作品 主题壁纸
com.PM.PirateDawn	海盗 黎明 海盗 黎明 piratedawn 世界 海盗 角色扮演游戏 驾驶 海盗船 世界 漫游 史诗 旅程 测试版 作者 kim stock ton 英文 探索 海盗 黎明 世界 海盗 角色扮演 3d 图形 战术 实时 漫游 世界 背叛 冒险 史诗 旅程 探索 海盗 黎明 世界 海盗 角色扮演 3d 图形 战术 实时 漫游 世界 背叛 冒险 史诗 旅程 海战 加勒比 角色扮演 海盗 冒险 动作 射击 小编 海战 加勒比 3d 角色扮演 海盗 冒险 动作射击 小编精选
com.mx.mxdsharde	哲学 哲学 视野 世界 资讯 哲学家 生平 老宅 康德 混世魔王 马克思 天才 尼采 传奇 生平 作者 梦翔 工作室 中文 内容 哲学 视野 世界 资讯 哲学家 生平 老宅 康德 混世魔王 马克思 天才 尼采 传奇 生平 哲学 电子书 图书 哲学 电子书 新闻阅读 图书
com.michael.doubanonline	豆瓣 online 聊天 相册 图像 视频 视频 聊天社交 图像 聊天 相册·图库
com.fx678.shenyan.finace	粤贵 银行 情通 粤贵 银行 情通 贵金属 团队 神雁 贵金属 汇通 贵金属 中国 诺德 金融 研究院 潜心 封闭式 压力 测试 财经 资讯 策略 消息面 实时 行情 横跨 行情 同步 电脑 封闭 局面 已获 广东省 贵金属 交易中心 国内 领先 专业 贵金属 投资 行情 贵金属 全球 市场 交易 行情 指标 新闻 交易 策略 投资 金融 资讯 实时 迅疾 行情 交易 诺德 金融 研究院 指标 财经 日历 神雁金评 实时 解盘 项目 点位 贴合 投资者 需求 运筹帷幄 贵金属 投资 贵金属 投资 乐趣 贵金属 品种 粤贵 天通 国际 金银 实时 数据 全球 市场 指标 经济 指数 报价 美元 欧元 人民币 原油价格 纳斯达克 道琼斯 上证指数 欧元 汇率 英镑 美元 美元 日元 澳洲 日经 ftse dax 数据 实时 走势图 财经 资讯 各国 央行 媒体 头条 银行 专家 机构 贵金属 品种 经济 指数 黄金 神雁 分析师 金评 策略 交易 团队 精心 诺德 金融 研究院 呱呱 财经 实时 解盘 投资理财 教学 金融 知识 金融 资讯 培养 金融 人才 作者 广东 神雁 贵金属 经营 厦门 分公司 中文 办公商务
com.yilucaifu.android.fund	财富 财富 互联网 白领 中产 家庭 可信赖 生活 金融理财 基金 银行 信托 券商 理财 理财产品 销售 金融 组合 金融 投资 理财 投资 顾问 资产 生命周期 理财 财富 国内 领先 p2p 理财 国际 网络媒体 战略 合作 收益 银行 已达 财富 投资 项目 金融机构 担保 本息 安全可靠 互联网 借贷 理财 门户 基金 专家 基金 几十只 基金 理财 公司理财 投资理财 助手 收益 理财 保本 保息 年化 收益 互联网 长短期 盈利 赚钱 理财 神器 钱包 货基 存取 零钱 分起 费用 银行利息 红包 本金 财神 理财 孤单 交流 理财 壕友 理财 本金 作者 财富 北京 中文 内容 固收 赚取 收益 理财 资本金 理财 bug4 细节 基金 股票投资 股票投资 金融理财 基金
com.wordsmobile.speedracing	极速 飙车 竞速 最广 受好评 赛车 游戏吧 準备 令人振奋 掌上 赛车 系好 安全带 踩下 油门 赛车 驾驶 剎车 街道 飆车 3d 赛车 视觉效果 玩法 赛车 屏幕 赛车手 飆车 躲避 汽车 致命 障碍 金币 解锁 赛车 道具 视觉 绚丽 速度感 作者 互联网 中文 竞速 体育 竞速 赛车 竞速 体育竞速 赛车
com.touch.babystory	宝宝 故事 宝宝 故事 美丽 童话故事 不腻 优美 儿歌 宝宝 成长 故事 友谊 生命 勇敢 成长 话题 解答 成长 困惑 快乐 成长 孩子 拥抱 大自然 故事 精彩纷呈 乐园 孩子 小溪 行走 星空 聊天 雪地 翻滚 鲜花丛 孩子 孩子 讲故事 小朋友 声音 乐趣 故事 宝宝 天性 美丽 童话故事 陶冶 孩子 情操 孩子 词汇量 培养 孩子 学习 兴趣 结果表明 家长 孩子 读书 讲故事 音乐 孩子 儿童智力 儿童 多动症 毛病 故事 宝宝 成长 美好 礼物 宝宝 故事 美丽 童话故事 不腻 优美 儿歌 宝宝 成长 故事 友谊 生命 勇敢 成长 话题 解答 成长 困惑 快乐 成长 孩子 拥抱 大自然 故事 精彩纷呈 乐园 孩子 小溪 行走 星空 聊天 雪地 翻滚 鲜花丛 孩子 孩子 讲故事 小朋友 声音 乐趣 故事 宝宝 天性 美丽 童话故事 陶冶 孩子 情操 孩子 词汇量 培养 孩子 学习 兴趣 结果表明 家长 孩子 读书 讲故事 音乐 孩子 儿童智力 儿童 多动症 毛病 故事 宝宝 成长 美好 礼物 电子书 生活实用 资讯阅读 母婴
iacobus.sailtracker	赛欧 组合 内置 gps 智能手机 航向 数据 船上 机制 板载 nmea 数据 作者 互联网 中文 体育竞速
com.rey.material.demo	materialdesign 开源 安卓库 github rey5137 github io material 项目 学习 单词 教育 语言学习·单词 教育培训
com.tapinator.city.car.stunts3d	3d 城市 特技 赛车 3d 城市 飞车 3d 城市 特技 赛车 citycarstunts3d 驾驶 炫酷 跑车 高难度 赛道 飙车 精彩绝伦 特技 赛道 表演 视觉 赛车 特技 赛车 充满活力 图形 旅程 史诗 障碍物 特技 街机 赛车 特技 炽热 比赛 跳跃 汽车 特技 3d 跑酷 竞速 赛车竞速 跑酷竞速
com.hiptic.ShaqDown	奥尼尔 奥尼尔 金币 修改版 奥尼尔 shaqdown 奥尼尔 动作 闯关 奥尼尔 末世 战士 人类 僵尸 魔爪 拯救 僵尸 奥尼尔 主角 shaquilleo neal 沙奎尔 奥尼尔 篮球 传奇人物 名人 动作游戏 主角 世界末日 丧尸 病毒 突变 奴役 人类 丧尸 品种 战士 shaq 突变体 丧尸 大战 shaqdown 新作 动作游戏 篮球 明星 shaquilleo neal 主角 沙克 人类 打败 邪恶 突变体 僵尸 卷轴 动作 个大恶 击败 突变体 丧尸 赚取 shaqra 解锁 生存 排行榜 分数 朋友 竞争 图像 动画 街头霸王 艺术家 longvo 绘画 shaq 朋友 世界冠军 摔跤手 leekemp 作者 onespearentertainment 英文 战士 shaq 真棒 权力 突变体 丧尸 大战 沙克 人类 打败 邪恶 突变体 植物 大战 僵尸 生存 排行榜 分数 朋友 竞争 奥尼尔 僵尸 动作 射击 横版 篮球 动作冒险 奥尼尔 篮球 僵尸 动作射击 横版
com.zg.fuxinbo_a	付辛博 壁纸 索星 壁纸 壁纸 锁屏 壁纸 静态 壁纸 美女 帅哥 明星 壁纸 随心换 美化 壁纸 美化手机 壁纸
com.qiugonglue.qgl_bangkok	曼谷 旅游 曼谷 主体 内容 连结 互联网 曼谷 美食 景点 购物 小贴士 地理位置 电话 实地 对身 曼谷 旅行者 gps 放上来 曼谷 美食 曼谷 小吃 流口水 别提 餐厅 baankhanitha narathaicuisine 美味 mangotree 小巷子 人气 超旺 harmonique 餐厅 一言难尽 购物 购物 天堂 俗气 siam 曼谷 购物 地狱 荷包 变瘪 变瘪 变瘪 变瘪 商场 地狱 超好 centralworld siamparagon mbk 几斤 时尚 曼谷 niraya 包包 景点 皇宫 四面佛 佛寺 卧佛寺 灵验 拜拜 水上 市场 泰拳 泰式 按摩 3g 上网 泰铢 换汇 机场 布局 作者 杭州 腾贵 中文 内容 商品 旅行 界面 缓存 导航条 分辨率 设备 web 内容 标题栏 工具条 自动隐藏 界面 功能完善 代码 健壮性 闪退 生活 旅游 旅游 出行 地图旅游 生活 旅游出行 旅游
cn.com.omttu.bdbiij20778.mobilewandoujia	安东尼 情书 安东尼 情书 唯美 短句 安东尼 情书 伤感 幸福 短句 爱情 悲伤 幸福 安东尼 情书 唯美 短句 安东尼 情书 伤感 幸福 短句 爱情 悲伤 幸福 电话 通讯 聊天 社交 短信 电话通讯 聊天社交 短信
com.imohoo.towers	怪物 塔防 一波 一波 怪物 袭击 家园 破坏性 守住 家园 武器 抵御 奇丑 怪物 袭击 作者 towerdefense 中文 经营策略
com.agmcs.FloatingShadow	悬浮 影子 悬浮 影子 辅助 操控 工具 界面 激活 全屏 全屏 随心 调节 色温 视觉 全屏 沉浸 乐趣 模拟 主页 单键 功能键 按键 优雅 聊天 网页 护目镜 屏幕 色温 蓝色 光波 黑暗 眼疲劳 模拟 按键 护目镜 全屏 root wifi bluetooth 屏幕 常亮 开关 休眠 root 快捷方式 皮肤 内置 主题 png 皮肤 电子邮件 skkg qq 悬浮 影子 辅助 操控 工具 界面 激活 全屏 全屏 随心 调节 色温 全屏 沉浸 乐趣 模拟 主页 单键 功能键 按键 优雅 聊天 网页 悬浮 影子 辅助 操控 工具 界面 激活 全屏 全屏 随心 调节 色温 全屏 沉浸 乐趣 模拟 主页 单键 功能键 按键 优雅 聊天 网页 悬浮 影子 辅助 操控 工具 界面 激活 全屏 全屏 随心 调节 色温 全屏 沉浸 乐趣 模拟 主页 单键 功能键 按键 优雅 聊天 网页 桌面 主题 美化 美化手机 系统工具 桌面·主题 电子书 资讯阅读
his.ontnp.bdcice21713.viewwandoujia	帝国 帝国 新手 起跑线 帝国 布局 知识 领先 起跑 世界 霸主 帝国 新手 起跑线 帝国 布局 知识 领先 起跑 世界 霸主 文件 工具 效率办公 文件管理 系统工具
com.kth.PuddingCamera	布丁 相机 布丁 相机 puddingcamera 韩国 拍照 hipstamatic ui 镜头 胶卷 拍摄 照片 视频 自拍模式 文件 472px 700px 1024px 拍摄 照片 拍摄 电子邮件 朋友 布丁 pudding 照片 v1 修正 作者 中文 滤镜 相机 拍照 滤镜 相机 图片分享 摄影摄像 拍照
com.amnongchangmoni.go	美国 农场 模拟器 养殖 技能 工作 移动设备 3d 农场 模拟器 小麦 农场 nbsp 农用车 拖拉机 机器 农业 工程 驾驶 巨型 三维 拖拉机 农场 风景如画 领域 白天 夜间 美国 乡村 宁静 景色 故事 美国 潜入 美国 农场 nbsp 农业 企业 打通 道路 培养 春耕 设备 土壤 播种 小麦 拖拉机 播种 领域 小麦 健壮 努力学习 庄稼 nbsp 美国 农场 模拟器 3d 农场 场景 驱动 车辆 牵引车 载货车 收割机 种植 小麦 挑战性 耕耘 小麦 驾驶 技能 机器 拖拉机 正本 模拟器 印象 农民 手脏 背部 paining 很酷 动作射击
com.tiantianmaicai	买菜 买菜 订菜 餐馆 饭店 工具 菜价 实时 蔬菜 fqa 检测 农药 残留 检测 菜类 肉类 粮油 下单 地头 厨房 菜类 买菜 助手 作者 成都 龙科技 中文 内容 酒水 模块 水果 模块 个人用户 购物优惠
com.baichebao	汽车 百车 国内 汽车 服务平台 车主 专业 实惠 汽车 比价 车型 里程 项目 国内 汽车 数据库 比价 同步 4s店 连锁店 上门 实惠 专业 搜索 生活 实用工具 工具 搜索·下载 生活实用工具 系统工具
com.bb.game	甜甜 世界 魔法 合体 道具 趣味十足 道具 萌萌 怪物 捣乱 益智 卡通 休闲 休闲时间 宝石消除 卡通 益智
com.leo.jokes	幽默 笑话 幽默 笑话 数万条 数据 简洁 流量 作者 紫霞 中文 内容 热乎乎 内涵 笑话 小破孩 吵架 乙说 嘴巴 风中 小说 幽默 笑话 搞笑 幽默 新闻阅读 小说 搞笑 笑话
com.muumuu.koikoi	动物 小鸟 动作 射击 休闲 网络游戏 动作射击 动作竞技 休闲时间
com.mm999.meiriyishou	一瘦 一瘦 美体 瘦身 计划 性感 女人 一瘦 美体 瘦身 教学 动画 健康 美体 塑身 瘦身操 瘦腿 瘦腹 瘦腰 手臂 瘦脸 美体 瘦身操 居家 雕塑 每一寸 一瘦 爱美的 mm 美体 瘦身 紧致 曲线 王道 瘦身 瘦身 教程 雕塑 每一寸 瘦身 瘦身 拍照 瘦身 瘦身 成果 点赞 瘦身 瘦身 圈子 身心 mm 减肥 瘦身 话题 交朋友 闺蜜 瘦身 瘦身 工具 赚美米 礼品 瘦身 瘦身 瘦身 美照 朋友 微信 好友 朋友圈 微博 qq 空间 短信 作者 深圳市 美蜜 中文 健康医疗
com.seventeenbullets.android.islandcn	天堂 中文版 天堂 中文版 paradiseisland 阳光 海水 游客 机遇 商业 帝国 游客 需求 游客 旅游 环境 娱乐中心 餐厅 迪斯科 舞厅 消费 天堂 岛上 建筑 设施 建筑 商业 帝国 购置 土地 海域 空间 利润 建筑 岛屿 商业伙伴 竞争 漂亮 图形界面 建筑 装饰 植物 奖励 作者 coopermediacorp 中文 内容 梦幻 天堂 经营策略
com.milticlick.game.newsniper	新人 阻击手 中文版 新人 阻击手 中文版 射击 发射 操作方法 射击 开枪 通关 能得 职业杀手 射击 射击 第三关 杀死 杀死 作者 丽人 工作室 中文 狙击 枪械 射击 狙击 飞行射击 枪械射击
com.asl.moblie.employ	聚聘 工作 足不出户 招工 企业 招聘 求职 好帮手 永久性 招聘 找工 定点 招聘 lbs 在全国范围内 智能手机 招聘 就业 招聘 沟通 足不出户 虚拟 面试 交流 招聘 效率 成本 pc 同步 互联 数据共享 高效 招聘 企业 招聘 企业 用工 招工难 需求 招工 中介 社会 风险 生活实用 生活服务
com.metek.longhuo	龙火 全球 对战 飞机 射击 网游 网游 飞机 闯关 架飞机 子弹 组合 僚机 飞机 抽筋 开机 飞机 龙火 地图 场景 boss 战是 战役 打赢 强者 下一关 竞技场 竞技场 排名 好汉 男人 真刀真枪 真人 飞机 对战 评价 牛德杰 太给力 真人 对战 飞机 刺激 真刀真枪 攻击力 排行榜 快乐 柠檬 摩托罗拉 龙火 画面感 良心 扣钱 丸子 小艾 设计师 用心 场景 每一关 细节 同类产品 好太多 真人 实时 对战 飞行 射击 神经 美女 僚机 美女 激情 敌机 攻击方式 boss 更具 场景 灵敏 穿梭 子弹 毫发 巅峰 作者 上海 扬讯 计算机 中文 网络游戏
com.mabin.bikeforzs	中山 自行车 实时 自行车 站点 站点 自行车 车位 实时 中山 地区 绿色 出行 好帮手 地图 导航 租房 短租 旅游 出行 交通 导航 交通导航 旅游出行 租房·短租 地图·导航 生活服务
com.remember_words	连网 背单词 背单词 单词 助记 发音 背单词 浪费 记忆 记忆 差别 学习 知识点 难易 背单词 引擎 会为 学习 矩阵 学习 知识点 参数 个体 科学 学习 复习 个性化 记忆 作者 bcdiei 中文 内容 闪退 bug2 记忆 算法 学习 学习 教育学习
com.sosoti.test.juniorchemistry12	初三化学 课后练习 初三化学 同步 单元 化学 世界 单元 单元 自然界 单元 物质 奥秘 单元 化学方程式 单元 氧化物 单元 燃料 单元 金属 金属材料 单元 溶液 单元 第十一 单元 化肥 第十二 单元 化学 生活 题目 内容 每章 每节 每道 练习题 解题 知识 薄弱环节 学习 该章 学生 随堂 考试 中学生 课后 知识 期中 期末考 错题 复习 作者 湖北 天翼 教育 中文 内容 修正 化学 学习 化学 学习 教育学习
com.wandoujia.wm.wdj	炫舞 英雄 互娱 劲舞团 团队 倾力 超人气 3d 舞手 指尖 舞蹈 全民 时代 全球 电竞 大赛 舞蹈 手游 潮歌 时尚 新装 舞步 劲舞 全民 舞王 网络游戏 经营 模拟 音乐 节奏 网络游戏 经营模拟 音乐节奏 休闲时间
com.fenbi.android.solar	小猿 搜题 湖南卫视 节目 学习 工具 唐嫣 华晨 魏晨 贾乃亮 李晨 陈翔 郑恺 张翰 明星 中小学 学生 拍照 搜题 小学 初中 高中 期中 期末 中考 高考 新浪 创业 奖小猿 拍照 极简 极省 流量 语文 数学 英语 物理 化学 生物 政治 历史 地理 各科 题目 配以 作文 好题 qq 微信 微博 小巧 相机 搜题 评价 shangmou 机器 扫描 搜索 财富 辜负 流量 kevinrolandz 小猿 目标性 搜题 搜题 节外生枝 么么 princess 一拍题 高效 小猿 新浪 微博 小猿 搜题 作者 北京 贞观 中文 内容 帐号 同步 题目 一题 按钮 变大 醒目 湖南卫视 节目 学习 工具 唐嫣 华晨 魏晨 贾乃亮 李晨 陈翔 郑恺 张翰 明星 中小学 学生 拍照 搜题 小学 初中 高中 期中 期末 中考 高考 新浪 创业 奖小猿 拍照 极简 极省 流量 语文 数学 英语 物理 化学 生物 政治 历史 地理 各科 题目 配以 作文 好题 qq 微信 微博 小巧 相机 搜题 评价 shangmou 机器 扫描 搜索 财富 辜负 流量 kevinrolandz 小猿 目标性 搜题 搜题 节外生枝 么么 princess 一拍题 高效 小猿 新浪 微博 小猿 搜题 作者 北京 贞观 中文 内容 帐号 同步 题目 一题 按钮 变大 醒目 小猿 搜题 初高中 搜题 利器 作业 拍照 初高中 科目 湖南卫视 节目 学习 工具 好题 qq 微信 微博 湖南卫视 节目 学习 工具 好题 qq 微信 微博 作业 解题 学习 教育 办公学习 教育培训 教育学习 学习 作业 解题
com.wunuo.smart	盒子 fb1 开关 摄像头 工具 系统工具
com.ezjoynetwork.jewelsmaze2	宝石 迷阵 精心设计 地图 大功率 ups 比赛 精心设计 地图 大功率 ups 比赛 精心设计 地图 大功率 ups 比赛 精心设计 地图 大功率 ups 比赛 宝石 休闲时间 宝石 宝石消除 卡通 益智
com.wumii.android.SITE.app_bftuczdy	瑜伽 教程 瑜伽 学习 教程 瑜伽 塑身 瑜伽 训练 塑形 燃脂 瑜伽 教程 专业 训练 课程 动作 更易 瑜伽 体式 瑜伽 哲理 呼吸 控制法 基础 瑜伽 体式 瑜伽 流派 教学 瑜伽 生活 乐趣 瑜伽 入门 作者 wumii 中文 健身 女性 健康 瑜珈 健康医疗 瑜珈 女性 健康 健身
cuga.fuc.gug.l.puzzle	puzzle 益智 pic 训练 brain laod 洗牌 friends 儿童 益智 智力开发 儿童益智 智力开发
com.chunky.free.live.tv	在线电视 在线电视 直播 电视节目 和工 设备 收看 网上 渠道 如加星 颜色 23categories 2g 3g wifi 作者 互联网 影音视听
com.rexsee.fch.s1kkq8i	裙舞 漂亮 裙子 换装 衣服 换装 作者 互联网 英文 休闲益智
cn.apppark.ckj10114726	高考 高考 高考 高考 高考 资讯 高考 招生 高考 政策 高考 高考 成绩 高考 招生简章 高考 辅导 艺术 高考 高考 录取分数 本科 院校 高职 专科院校 学院 高等院校 联系电话 新闻 考试 驾考 新闻 资讯 新闻阅读 考试·驾考 教育培训 新闻·资讯
com.handcool.wifi86	无线 充值 查账 上网 设备 wi fi 工具 wi-fi 系统工具
com.noinfo.math2	速算 长期实践 简捷 算法 中国 流传 一千多年 历史 计算能力 培养 思维 敏捷性 速算 教程 下册 速算 练习题 内容 速算 测试 随机 题目 测试 测试 题目 作者 noinfo 中文 电子书 图书 电子书 新闻阅读 图书
com.tsgame.brain	大脑 江苏 卫视 大脑 节目 热播 节目 契合 同名 大脑 节目 关卡 赛区 中国 战队 头像 激扬 背景音乐 挑战性 宝石 关卡 道具 作者 长江 龙新 媒体 中文 江苏 卫视 大脑 节目 热播 节目 契合 同名 大脑 节目 关卡 赛区 中国 战队 头像 激扬 背景音乐 挑战性 宝石 关卡 道具 作者 长江 龙新 媒体 中文 热游 休闲 益智 综艺 闯关 解谜 休闲 益智 益智 休闲益智 综艺 闯关 360精品游戏 解谜 休闲 热游推荐
com.refine.s1	地图 模块 手机号 号码 搜索 工具 搜索·下载 系统工具
com.wargames.gd	星河 防线 兵力 指挥 防御 阵型 敌人 有来无回 蜘蛛 能量 芯片 死亡 脉冲 空袭 emp 护盾 华丽 视听享受 兵力 指挥 防御 阵型 敌人 有来无回 蜘蛛 能量 芯片 死亡 脉冲 空袭 emp 护盾 华丽 视听享受 兵力 指挥 防御 阵型 敌人 有来无回 蜘蛛 能量 芯片 死亡 脉冲 空袭 emp 护盾 华丽 视听享受 防守 经营策略 塔防守卫 宝石消除 经营策略 卡通
com.example.my.bus.suzhou	苏州 实时 公交 苏州 实时 公交 智能手机 实时 公交 公交线路 公交车 实时 出行 等车 交通 导航 公交 火车 航班 交通导航 公交·火车·航班
com.coke.crabsandpenguins	螃蟹 企鹅 crabsandpenguins 数据包 酷夏 可口可乐 航船 大海 冒险 清爽 一夏 英雄 螃蟹 聚居 海盗船 残骸 鲨鱼 禁区 热带 抵达 严寒 危险 北极 地区 足球 硬币 奖励 鲸鱼 北极熊 朋友 企鹅 欢笑 jump 跳起 金币 3d 海洋 世界 关卡 数据包 shouji 360safe 360sj adm oth coke crabsandpenguins zip 数据包 路径 数据包 解压 复制到 sdcard obb 作者 coca cola 英文 数据包 机型 数据包 mb 机型 机型 机型 动作冒险
com.china.cbp.jq	文星 军棋 文星 军棋 盲人 游戏软件 读屏 中国 盲文 图书馆 辅助 技术 研究所 fzjsyjs 棋类 棋牌桌游
com.r22software.tooncam2	卡通 相机 生活 生活 照片 卡通 相机 卡通 风格 纹理 照片 艺术作品 艺术 卡通 卡通 素描 照片 计算机 相机 拍摄 原始 照片 画廊 dropbox 过滤器 网格 过滤器 共享 instagram 作者 互联网 摄影摄像
com.famouscall.joke	笑话 搞笑 网上 笑话 新闻 电子书 日报 杂志 电子书 新闻阅读 日报·杂志
com.eagle.game.mota	魔塔 传奇 魔塔 美工 绘制 画面 把玩 诱惑 opengl 引擎 市面上 运行 画面 作者 互联网 中文 角色扮演
dianjin.begame.mengzhify.hjsywdb	黄金 沙鹰 射击 黄金 沙鹰 血量 通关 黄金 骷髅 消灭 敌人 作者 塔防 英文 动作冒险
com.colorme.game.ptmeiwei	pt 美味 胖胖 快餐店 动物 吃些 作者 互联网 中文 经营策略
com.autoconnectwifi.app	wifi 连网 神器 wifi 连网 神器 简洁 流量 wifi 管理工具 wifi 连网 神器 云端 数据 中国移动 cmcc 中国联通 中国电信 wlan 网络服务 加密 wifi 热点 wifi 连网 神器 上网 小说 电影 美图 新闻 漫画 玩游戏 音乐 地图 团购 淘宝 专车 出差 旅游 购物 学习 神器 wifi 畅快 娱乐 流量 苦恼 上网 qq 空间 新浪 微博 豆瓣 飞信 恩爱 社交 购物 天猫 唯品会 聚美优品 苏宁易购 大众 团购 娱乐 懒人 酷狗 音乐 布卡 漫画 腾讯 视频 爱奇艺 暴风 影音 酷跑 消消 节奏 大师 梦幻 西游 打发 学习 办公 效率 百词 金山词霸 词典 头条 腾讯 新闻 网易 新闻 时事 智慧 东方 财富网 雪球 股票行情 出行 打车 uber 优步 打车 神舟 专车 旅行 机票 火车票 旅游 出行 好伴侣 作者 北京 掌宇 文化 中文 内容 扩展 密码 覆盖全国 密码 修正 wifi wifi 顺畅 bugfixes wifi 连网 神器 简洁 流量 wifi 管理工具 wifi 连网 神器 云端 数据 中国移动 cmcc 中国联通 中国电信 wlan 网络服务 加密 wifi 热点 wifi 连网 神器 上网 小说 电影 美图 新闻 漫画 玩游戏 音乐 地图 团购 淘宝 专车 出差 旅游 购物 学习 神器 wifi 畅快 娱乐 流量 苦恼 上网 qq 空间 新浪 微博 豆瓣 飞信 恩爱 社交 购物 天猫 唯品会 聚美优品 苏宁易购 大众 团购 娱乐 懒人 酷狗 音乐 布卡 漫画 腾讯 视频 爱奇艺 暴风 影音 酷跑 消消 节奏 大师 梦幻 西游 打发 学习 办公 效率 百词 金山词霸 词典 头条 腾讯 新闻 网易 新闻 时事 智慧 东方 财富网 雪球 股票行情 出行 打车 uber 优步 打车 神舟 专车 旅行 机票 火车票 旅游 出行 好伴侣 作者 北京 掌宇 文化 中文 内容 扩展 密码 覆盖全国 密码 修正 wifi wifi 顺畅 bugfixes wifi 连网 神器 简洁 流量 wifi 管理工具 wifi 连网 神器 上网 小说 电影 美图 新闻 漫画 玩游戏 音乐 地图 团购 淘宝 专车 出差 旅游 购物 学习 wifi 热点 星巴克 商家 热点 wifi 连网 神器 简洁 流量 wifi 管理工具 wifi 连网 神器 上网 小说 电影 美图 新闻 漫画 玩游戏 音乐 地图 团购 淘宝 专车 出差 旅游 购物 学习 wifi 热点 星巴克 商家 热点 wi fi 上网 wifi 工具 上网 系统工具 系统安全 wifi wi-fi
com.youai.qile.kot.a.d.lewan	推倒 帝国 玩法 让玩家 闯关 精英 关卡 竞技场 锻造 招贤 尖端技术 特效 特效 中国 尖端技术 最炫 战术 特效 攻击 技能 组合 伤害 全屏 技能 秒杀 攻击 一招毙命 中有 装备 锻造 图纸 空间 防御 搭配 策略 组合 玩法 让玩家 闯关 精英 关卡 竞技场 锻造 招贤 尖端技术 特效 特效 中国 尖端技术 最炫 战术 特效 攻击 技能 组合 伤害 全屏 技能 秒杀 攻击 一招毙命 中有 装备 锻造 图纸 空间 防御 搭配 策略 组合 玩法 让玩家 闯关 精英 关卡 竞技场 锻造 招贤 尖端技术 特效 特效 中国 尖端技术 最炫 战术 特效 攻击 技能 组合 伤害 全屏 技能 秒杀 攻击 一招毙命 中有 装备 锻造 图纸 空间 防御 搭配 策略 组合 闯关 防守 三国 三国 角色扮演 塔防守卫 闯关
com.u9time.qmttd.wdj	全民 春丽 克劳德 八神 奎爷 作品 角色 登陆 英雄 守护 世界 春丽 克劳德 八神 奎爷 作品 角色 登陆 英雄 守护 世界 春丽 克劳德 八神 奎爷 作品 角色 登陆 英雄 守护 世界 春丽 克劳德 八神 奎爷 作品 角色 登陆 英雄 守护 世界 春丽 克劳德 八神 奎爷 作品 角色 登陆 英雄 守护 世界 回合制 角色扮演 街机 回合制 网络游戏 卡牌 街机 体育格斗 角色扮演
com.qixin.bchat	企信 企信 全球 中小型企业 标准化 流程化 系统化 协作 互联网 数据 技术 助力 中小型企业 互联网 时代 高效 作者 上海 企信 企业 中文 内容 v1 内容 组织 组织 进度 五分钟 进度 效率 办公 效率办公 办公商务
com.xueda.qinxue	名师 学堂 名师 学堂 先进 教育 精髓 最优 在线教育 资源 学员 互动学习 辅助 学生 学好 课程 名师 学堂 单元 期中 期末 复习 名师 公益 课程 课程 专职 助教 全天 学生 课程 疑问 作者 陕西 阳光 教育 中文 内容 模块 教育学习
com.ttyouxi.gameOctfifaca	公主 换装 女孩 公主 梦想 女孩 最美 公主 最美 公主 spa 化妆品 化妆 漂亮 衣服 好玩儿 朋友 经营养成 装扮
com.makeapp.game.popstar	果果 堆得 奖励 堆得 奖励 方块 宝石 减压 方块 宝石消除 减压
zj.android.corpse3.zj360	僵尸 大战 一大 僵尸 萌系 休闲 射击 手游 僵尸 大战 可爱 q版 妹子 追击 僵尸 幕后 黑手 超贱 嘟比猴 军团 易懂 突突突 繁琐 妹子 爱玩 抓捕 嘟比猴 大王 休闲游戏 业界 通用 虚拟 按键 易上 超萌 主角 怪物 老少皆宜 玩法 关卡 召唤 墓碑 信波 雷达 vip 嘟比猴 游玩 内容 形态 主角 武器 坐骑 宠物 道具 主角 攻击 视觉 听觉 超爽 联网 排名 战力 战力 作者 合肥 娱乐 信息技术 中文 内容 连杀 枪枪 暴击 主角 特效 炫酷 华丽 武器 特效 拔群 射击 飞行射击 射击
com.hc87	p2f 理财 p2f 理财 成都 信息技术 孳孳 理财 p2f 金融机构 理财 投资 收益 投资 门槛 投资 理财工具 金融理财 理财工具 金融理财
impossible.penalty.shootout.game	巴西 欧元 罚款 欧洲杯 伦敦 奥运会 欧洲 资格 巴西 贵国 得分 地滑过 气球 射门 偏出 创新 工程技术 智力 乒乓 迷人 刺激 闪闪发光 足球 足球比赛 欧元 伦敦 奥运会 资格 巴西 欧洲 足球 足球 温暖 点球 神经 欧洲杯 点球 运动 国家 欧洲杯 命运 尽全力 辉煌 欧洲 冠军 奖杯 欧洲杯 点球 足球 主题 新手 点球 基本知识 欧洲杯 点球 挑战性 刑罚 节奏 欧锦赛 足球 主题 生气 欧洲杯 欧洲杯 点球 团队 appeggs 欧元 伦敦 奥运会 欧洲 巴西 足球 足球 锦标赛 资格 比赛 欧洲 伦敦 奥运会 巴西 比赛 关押 波兰 乌克兰 伦敦 欧洲 欧洲 资格 国家 团队 哪支 球队 点球 克罗地亚 马其顿 苏格兰 塞尔维亚 威尔士 亚美尼亚 保加利亚 捷克共和国 丹麦 意大利 马耳他 奥地利 法罗群岛 德国 哈萨克斯坦 斯坦 爱尔兰共和国 瑞典 安道尔 爱沙尼亚 匈牙利 荷兰 罗马尼亚 土耳其 阿尔巴尼亚 塞浦路斯 挪威 斯洛文尼亚 瑞士 阿塞拜疆 以色列 卢森堡 北爱尔兰 葡萄牙 俄罗斯 波斯尼亚 希腊 拉脱维亚 列支敦士登 立陶宛 斯洛伐克 英国 摩尔多瓦 黑山 波兰 圣马力诺 乌克兰 白俄罗斯 芬兰 法国 格鲁吉亚 西班牙 伦敦 罚则 上场 阿拉伯联合酋长国 英国 乌拉圭 塞内加尔 墨西哥 韩国 加蓬 巴西 埃及 新西兰 日本 洪都拉斯 摩洛哥 美国 中国 秘鲁 球队 欢呼 国家 欧元 伦敦 奥运会 欧洲 资格 巴西 点球 惊险 泄漏 刑罚 锁定 欧元 伦敦 奥运会 球场上 点球 神经 指甲 咀嚼 手指 眼睛 球员 欧元 伦敦 奥运会 罚则 进球 点球 大战 球场 门将 工作 头疼 点球 欧元 伦敦 奥运会 罚款 中有 国家 工作队 欧元 伦敦 奥运会 巴西 欧洲 资格 欧洲 锦标赛 伦敦 奥运会 巴西 欧洲 资格 作者 互联网 英文 体育竞速
com.mow.tingshu	魔王 魔王 听书 相声 评书 音质 相声 评书 内容 相声 评书 利器 评书 内容 评书 表演艺术家 单田芳 袁阔成 刘兰芳 田连元 连丽如 王玥 作品 新派 评书 海贼王 斗破 苍穹 盗墓 笔记 魔王 听书 收录 相声 内容 收录 郭德纲 岳云鹏 马三立 刘宝瑞 侯宝林 马季 马志明 姜昆 曹云金 嘻哈 包袱 相声 大师 演员 团体 作品 魔王 书馆 演出 社区 书馆 书馆 评书 相声 内容 艺术家 内容 图标 搜索 内容 艺术家 艺术家 作品 专辑 专辑 内容 播放 内容 内容 通用 搜索 专辑名称 艺术家 内容 收听 播放 历史记录 演出 魔王 听书 相声 演出 城市 社区 社区 论坛 论坛 发帖 帖子 内容 内容 大圣 西游记 花千骨 主宰 郭德纲 岳云鹏 单田芳 武林 修真 评书 相声 故事 青雪 小说 袁阔成 刘兰芳 古龙 白眉 大侠 红楼梦 言情 三国演义 盗墓 坏蛋 粤语 天才 鬼吹灯 坏蛋 葫芦娃 火影 作者 北京 魔王 中文 内容 版本号 轮播 专题 插拔 耳机 闪退 播放 魔王 听书 评书 内容 评书 表演艺术家 单田芳 袁阔成 刘兰芳 田连元 连丽如 王玥 作品 相声 内容 收录 郭德纲 岳云鹏 马三立 刘宝瑞 侯宝林 曹云金 相声 大师 演员 团体 作品 魔王 书馆 演出 社区 书馆 书馆 评书 相声 内容 艺术家 内容 图标 搜索 内容 艺术家 艺术家 作品 专辑 专辑 内容 播放 内容 内容 通用 搜索 专辑名称 艺术家 内容 收听 播放 历史记录 演出 魔王 听书 相声 演出 城市 内容 大圣 西游记 花千骨 主宰 郭德纲 岳云鹏 单田芳 武林 修真 评书 相声 故事 青雪 小说 袁阔成 刘兰芳 古龙 白眉 大侠 红楼梦 言情 三国演义 盗墓 坏蛋 粤语 天才 鬼吹灯 魔王 听书 魔王 书馆 演出 社区 专辑 内容 播放 内容 内容 新闻 灵异 武侠 仙侠 历史 相声 新闻阅读 灵异 武侠 仙侠 听书 历史 相声 电子书 资讯阅读
com.weshi.imusic.imusicapp	音乐 电台 音乐 电台 音乐
com.qmtiku.categoryId_12	工程师 考试 题库 工程师 考试 启明 教育 工程师 题库 考试 学员 题量 题库 章节 教材 章节 章节 知识点 练习题 每道题 试题 真题 真题 模拟 应试 环境 考试分数 答题 考试 真题 考前 押题 启明 题库 押题 密卷 必考 考点 错题 容纳 知识 盲点 讲义 讲义 考点 学习 学习 轨迹 考试 通过率 作者 北京 联创 启明 教育 中文 内容 支付 bug2 ui 题量 启明 教育 工程师 题库 工程师 考试 学员 题量 题库 考试 驾考 题库 资格证 教育 考试 资格证 题库 教育培训 教育学习 考试·驾考 考试
com.ty.dycxy.dxayxwf.waifang360	大鱼吃小鱼 海底 总动员 大鱼吃小鱼 休闲 益智类 刺激 大自然 弱肉强食 法则 关卡 敌人 造型 超萌 可爱 鱼类 凶恶 首领 怪物 感悟 人生 道理 作者 北京 盛天游 中文 内容 mm 派生 三网 计费 休闲益智
com.meimei20091013.texiaoxunwei20121024	特效 穴位 按摩 治病 以下内容 按摩 穴位 治感冒 眼疲劳 保健法 眼部 按摩 美容 眼部 眼睛 头痛 面部 按摩 瘦脸 穴位 健鼻 养生 防病 过敏性 鼻炎 按摩 减肥 按摩 催眠 按摩 太阳穴 白内障 贫血 腿部 浮肿 按摩 腿部 穴位 按摩 腿肚 小腿 浮肿 点穴 减肥 摩腹 养生 补泻 合谷 排便 揉摩 耳廓 健康 鼻梁 牙痛 按摩 治疗 老年斑 脚趾 健胃 前列腺 肥大 按摩法 涌泉穴 主治 疾病 治疗 脚部 淤血 按摩 治尿不净 中药 敷脐 穴位 治病 穴位 涌泉穴 主治 疾病 保健 八段锦 作者 互联网 中文 以下内容 按摩 穴位 治感冒 眼疲劳 保健法 眼部 按摩 美容 眼部 眼睛 头痛 面部 按摩 瘦脸 穴位 摩腹 养生 补泻 合谷 排便 中药 敷脐 穴位 治病 穴位 按摩 新闻 电子书 中医 健康 新闻阅读 中医 健康医疗 电子书 健康 按摩
com.kuxuexi.k12pad	学习 学习 内容 涵盖面 大学 知识 内容 数学 物理 化学 英语 生物 语文 历史 地理 教学 视频 小升初 中考 高考 视频 教学内容 领域 知识 科学 学习 高手 会为 解惑 新闻 考试 驾考 教育 新闻阅读 考试·驾考 教育培训
com.magook.kind0_1449	青岛 画报 青岛 青岛 画报 创刊 创刊 画报 青岛 日报 报业 集团 青岛 画报 编辑部 编辑出版 青岛市 铜版纸 彩印 画报 发行量 省市级 画报 期刊 名列前茅 创新 生活 人生 青岛 画报 办刊 宗旨 内容 都市生活 旅游 文化 历史 时尚 视觉 独有 资源优势 青岛 生活 新闻 画报 画报 新闻阅读
com.netmite.andme.launcher.the_simpsons_2_freem	辛普森一家 辛普森一家 公园 冒险 玩法 河马 玛姬 霸子 丽莎 拯救 世界 免于 陷入 辛普森 家庭 穿梭 春田 小镇 世界 击败 匪徒 征战 途上 讽刺 作者 北京 摩部 世界 英文 角色扮演
com.veewo.Get10	合到 原班人马 数字 助手 天才 抓狂 色彩缤纷 方块 数字 长大 数字 合到 更高 易上 手难 画面 美妙 音乐 googleplay 平板电脑 色彩 作者 veewo 繁体中文 汉化 休闲 益智 休闲 小编 汉化 休闲益智 最热游戏 休闲 小编精选
com.sinyee.babybus.clothes	宝宝 制衣 衣服 宝宝 奇奇 服装 工厂 宝宝 制衣 奇奇 服装 工厂 棉花 甲醛 残留 杂质 消灭 衣服 难受 消灭 制出 衣服 织布 黑心 棉花 虫子 棉花 扔进 垃圾桶 印染 手指 消灭 可恶 甲醛 衣服 线头 断针 挑出 合格 场景 孩子 衣服 衣服 宝宝 巴士 babybus 启蒙 教育 启发 学习 培养 认知 寓教于乐 填鸭式 教学 宝宝 巴士 快乐 童年 家庭 早教 幼儿教育 专家 ps 搜索 宝宝 巴士 检索 宝宝 巴士 babybus 宝宝 巴士 父母 非常重视 儿童 健康 隐私 隐私政策 babybus index privacypolicy shtml 微信 宝宝 巴士 微博 宝宝 士官 babybus 邮箱 ser babybus 作者 宝宝 巴士 福建 中文 内容 流量 wifi 爸爸妈妈 流量 瘦身 空间 宝宝 宝宝 巴士 界面 ui 界面 画面 细腻 宝宝 休息 休息 页面 声音 宝宝 奇奇 休息 运行 谷歌 android5 场景 孩子 衣服 衣服 家庭 早教 幼儿教育 专家 ps 搜索 宝宝 巴士 检索 宝宝 巴士 babybus 场景 孩子 衣服 衣服 家庭 早教 幼儿教育 专家 ps 搜索 宝宝 巴士 检索 宝宝 巴士 babybus 场景 孩子 衣服 衣服 家庭 早教 幼儿教育 专家 ps 搜索 宝宝 巴士 检索 宝宝 巴士 babybus 场景 孩子 衣服 衣服 家庭 早教 幼儿教育 专家 ps 搜索 宝宝 巴士 检索 宝宝 巴士 babybus 儿童 教育 儿童教育 识图 玩游戏 丽人 母婴 益智 儿童游戏 玩游戏 教育培训 儿童教育 识图 丽人母婴 3-7岁 益智
tw.ims.mirror	鏡子 美丽 出们 镜子 镜子 梳理 镜子 作者 互联网 英文 生活休闲
com.kekeclient_	英语 英语 英语 随身听 不耗 流量 花钱 收听 voa 慢速 voa 常速 bbc cnn npr cri ted 纪录片 电影 美剧 原声 英文歌曲 美文 演讲 有声读物 内容 三千多 英语 学习 节目 万篇 声音 内容 节目 订阅 节目 一有 收听 mp3 中英 字幕 不耗 流量 花钱 听力 训练 语音 同步 双语 字幕 单句 精听 听力 口语 训练 逐句 跟读 智能 口语 评分 实时 打分 攻克 开口 难关 学习 小组 英语 小组 语音 互动 交友 学习 孤单 学习 同步 按划 夜间 课文 生词 标注 内容简介 欧美 广播 voa 慢速 voa 常速 bbc cnn npr cri apnews abc 科学 美国 影视音乐 欧美 电影 美剧 原声 英剧 原声 英文歌曲 听歌 英语 英语听力 入门 听力 听力 美文 英文 演讲 有声读物 ted 公开课 纪录片 英语口语 音标 发音 生活 口语 商务 口语 旅游 口语 金融 口语 法律 口语 医疗 口语 英语考试 英语 四级 六级 翻译 bec 专四 专八 sat 雅思 托福 gre 概念 英语 概念 第一册 第二册 第三册 第四册 mp3 视频 课程 学习 笔记 少儿英语 英文 儿歌 童谣 英文 童话故事 字母 儿歌 英语 启蒙 剑桥 少儿英语 双语 时事 教育 趣图 职场 体育 娱乐 社会 经济 健康 故事 评价 摘录 真心 蛮好 学习 大赞 很棒 好助手 挺好用 易懂 内容 内容 内容 学习 英语 学习 大赞 疑问 kekenet comapp 交流 qq 微信 公众 ikekenet 新浪 微博 weibo kekenet 电话 qq 作者 北京 中文 内容 v2 播放 缓存 收听 不耗 流量 音频 听边 变速 细节 英语 英语 随身听 不耗 流量 花钱 收听 voa 慢速 voa 常速 bbc cnn npr cri ted 纪录片 电影 美剧 原声 英文歌曲 美文 演讲 有声读物 内容 三千多 英语 学习 节目 万篇 声音 内容 节目 订阅 节目 一有 收听 mp3 中英 字幕 不耗 流量 花钱 听力 训练 语音 同步 双语 字幕 单句 精听 听力 口语 训练 逐句 跟读 智能 口语 评分 实时 打分 攻克 开口 难关 学习 小组 英语 小组 语音 互动 交友 学习 孤单 学习 同步 按划 夜间 课文 生词 标注 内容简介 欧美 广播 voa 慢速 voa 常速 bbc cnn npr cri apnews abc 科学 美国 影视音乐 欧美 电影 美剧 原声 英剧 原声 英文歌曲 听歌 英语 英语听力 入门 听力 听力 美文 英文 演讲 有声读物 ted 公开课 纪录片 英语口语 音标 发音 生活 口语 商务 口语 旅游 口语 金融 口语 法律 口语 医疗 口语 英语考试 英语 四级 六级 翻译 bec 专四 专八 sat 雅思 托福 gre 概念 英语 概念 第一册 第二册 第三册 第四册 mp3 视频 课程 学习 笔记 少儿英语 英文 儿歌 童谣 英文 童话故事 字母 儿歌 英语 启蒙 剑桥 少儿英语 双语 时事 教育 趣图 职场 体育 娱乐 社会 经济 健康 故事 评价 摘录 真心 蛮好 学习 大赞 很棒 好助手 挺好用 易懂 内容 内容 内容 学习 英语 学习 大赞 疑问 kekenet comapp 交流 qq 微信 公众 ikekenet 新浪 微博 weibo kekenet 电话 qq 作者 北京 中文 内容 v2 播放 缓存 收听 不耗 流量 音频 听边 变速 细节 英语 英语 随身听 在线听 wifi 收听 全免费 不耗 流量 花钱 上下班 寂寞 旅途 英语 内容 三千多 英语 学习 节目 万篇 声音 内容 节目 订阅 节目 一有 收听 mp3 中英 字幕 不耗 流量 花钱 听力 训练 语音 同步 双语 字幕 单句 精听 听力 口语 训练 逐句 跟读 智能 口语 评分 实时 打分 攻克 开口 难关 学习 小组 英语 小组 语音 互动 交友 学习 孤单 学习 同步 按划 夜间 课文 生词 标注 节目 voa 慢速 voa 常速 bbc cnn npr cri 科学 美国 经济学 有声读物 双语 名著 美文 英语演讲 概念 英语 欧美 电影 美剧 商务 口语 职场 口语 生活 口语 交流 qq 英语 英语 随身听 在线听 wifi 收听 全免费 不耗 流量 花钱 上下班 寂寞 旅途 英语 内容 三千多 英语 学习 节目 万篇 声音 内容 节目 订阅 节目 一有 收听 mp3 中英 字幕 不耗 流量 花钱 听力 训练 语音 同步 双语 字幕 单句 精听 听力 口语 训练 逐句 跟读 智能 口语 评分 实时 打分 攻克 开口 难关 学习 小组 英语 小组 语音 互动 交友 学习 孤单 学习 同步 按划 夜间 课文 生词 标注 节目 voa 慢速 voa 常速 bbc cnn npr cri 科学 美国 经济学 有声读物 双语 名著 美文 英语演讲 概念 英语 欧美 电影 美剧 商务 口语 职场 口语 生活 口语 交流 qq 内容 三千多 英语 学习 节目 万篇 声音 内容 学习 小组 英语 小组 语音 互动 交友 学习 孤单 学习 同步 按划 夜间 课文 生词 标注 口语 听力 教育 voa 学习 单词 学习 bbc 英语 口语 听力 办公学习 教育培训 教育学习 voa 考试学习 语言学习·单词 学习 bbc 英语
com.gateguruapp.android	gateguru 国际 航班信息 gateguru cnn 全球排名 航班信息 美国 加拿大 欧洲 亚洲地区 机场 gateguru 还同 出行 tripit kayaktrip 应用软件 旅游 行程 登机口 安检 机场 gateguru 机场 餐饮 购物 实用信息 条目 配以 照片 facebook twitter 出行 作者 互联网 英文 航班 航班 出行 航班查询 地图旅游 航班 出行
com.wedo1.TrafficMotoFREE	摩托 摩托 赛车 玩法 双向 车道 穿梭 午夜 漆黑 极速 一刻 重力 感应 操控 感触 冲击力 布景 感触 极速 音乐 细节 画面 精密 视觉 作者 厦门 云域 中文 体育竞速
card.mugeda.com	司令 司令 北京 乐享 云创 微信 微博 社交 智能手机 播放 html5 媒体 贺卡 酷炫 动画 交互 贺卡 文字 拍张 照片 贺卡 音乐 个性化 需求 情感 司令 节日 节日 贺卡 同事 生日 婚礼 爱情 友情 类别 传情 贺卡 微信 公众 mucard 贺卡 html5 动画 疙瘩 mugeda mugeda 司令 关系 亲密 作者 北京 乐享 云创 中文 内容 疙瘩 微卡 更名 司令 酷炫 微卡 修正 微卡 声音 自动播放 修正 相册 司令 北京 乐享 云创 微信 微博 qq 社交 智能手机 播放 html5 媒体 贺卡 酷炫 动画 交互 贺卡 文字 拍张 照片 贺卡 音乐 个性化 需求 情感 社交 聊天 社交 交友 社交 交友 聊天社交 通讯社交
com.winsland.ietv	常亮 屏保 应用软件 屏幕 常亮 关不掉 播放 视频 内容 内容 每周一次 联网 自动更新 零售 企业 集中管理 内容 内容 播放 运营 客户服务 专线 数据 统计分析 作者 北京 恒信 彩虹 信息技术 中文 内容 内容 bug3 屏幕 亮度 常亮 应用软件 屏保 屏幕 常亮 关不掉 播放 内容 销售者 店员 零售 企业 运营商 店面 店面 销售 革命 创新 时代精神 营业厅 变革 3giess 咨询 常亮 应用软件 屏保 屏幕 常亮 关不掉 播放 内容 销售者 店员 零售 企业 运营商 店面 店面 销售 革命 创新 时代精神 营业厅 变革 3giess 咨询 常亮 应用软件 屏保 屏幕 常亮 关不掉 播放 内容 销售者 店员 零售 企业 运营商 店面 店面 销售 革命 创新 时代精神 营业厅 变革 3giess 咨询 零售 企业 运营商 店面 店面 销售 革命 创新 时代精神 营业厅 变革 工具 效率 办公 屏幕 办公商务 桌面美化 系统工具 效率办公 系统设置 屏幕 主题壁纸 主题
land	com.uangel.tomokids_freesong 儿童乐园 kids land 儿童乐园 kidsland 英文 教育 趣味性 英文 教育 宝宝 娱乐 学习 父母 儿童教育 娱乐 收费 英文 教育 父母 方便使用 童话 电子书 儿歌 视频 宝宝 妈妈 宝宝 英语教育 宝宝 英文 学习 儿童乐园 娱乐 生活实用
shn.youtube.mp4	音乐 播放器 mp4 视频 youtube 平板电脑 视频 视频 单击 民众 赞成 mp3 工作 得病 mp3 mp4 病毒 垃圾邮件 广告 作者 互联网 影音视听
tv.rgmhpk.juhlki.jupuvjnr	nba 2k14 nba 2k14 欧洲 联赛 队伍 重新加入 国际 篮球 顶尖 欧洲 联赛 俱乐部 队伍 对抗 美国 球队 角色扮演 电子书 新闻 角色扮演 电子书 新闻阅读
com.ustwo.whaletrailfrenzy	飞天 鲸鱼 爆表 飞行 广告 泡泡 尽情 翻跟斗 技能 消灭 敌人 解锁 服装 结交 人物 角色 玩法 爆表 飞行 广告 泡泡 尽情 翻跟斗 技能 消灭 敌人 解锁 服装 结交 人物 角色 玩法 爆表 飞行 广告 泡泡 尽情 翻跟斗 技能 消灭 敌人 解锁 服装 结交 人物 角色 玩法 动作 射击 休闲 网络游戏 动作竞技 休闲时间 动作射击
com.mnapps.cameraadvancelite	摄像头 工具 cameraadvance 摄像头 工具 摄像头 拍照 抢拍 拍照 照片 噪点 全景 缩放 设备 补偿 设备 现场 相机 直方图 内置 触控 相册 操作界面 音量 照片 拍摄 按钮 重力 感应 相机 照片 图片库 焦距 第一张 照片 作者 mnapps 英文 相机 相机 摄影摄像
cn.kting.singlebook.ui17803	使命 水落石出 集齐 九龙 飞天 茶具 闯王 新闻 电子书 新闻阅读 电子书 听书
com.tf.thinkdroid.amarket	办公 套件 thinkfreeofficemobile 办公 套件 汉化版 thinkfreeofficemobile office 文档 工具 word excel powerpoint pdf 文档 word excel powerpoint 文档 pdf 远胜于 officesuitepro pc 办公 文件 作者 thinkfreemobile 中文 内容 excel word office 文档 办公商务 office excel word 文档
com.zhule.lottery	助乐 彩票 助乐以 每注 彩票 捐献 分钱 大学生 公益活动 微益代 爱心 人士 社会 天下 贫苦 幸福 购物 商城 彩票 购物 彩票 金融理财 商城
com.welovemm.mmreader817	随机应变 口才 一言之辩 重于 九鼎 三寸之舌 之师 中国 南北朝 学者 刘勰 文心雕龙 中曾 高度评价 口才 口才 原子弹 金钱 时代 武器 人类 文明 社会 检验 口才 中有 流利 熟人 东拉西扯 紧要关头 随机应变 口才 身陷 窘境 得罪 妙语连珠 巧于 周旋 羡慕 升迁 爱情 笨嘴笨舌 随机应变 口才 作者 互联网 中文 新闻阅读
com.xiangrikui.sixapp	im 保险人 im 保险人 代理人 生活 互动 经营 代理人 吸纳 保险客户 真心 点赞 im 保险人 代理人 生活 互动 经营 代理人 吸纳 保险客户 真心 点赞 聊天 社交 社区 聊天社交 社区
com.hoolai.zcfy.qihoo	中超 风云 中国 足球 爱好者 量身定制 足球 手游 3d 足球 手游 精度 中超 风云 3d 场景 建模 中超 大球场 爆满 工体 虹口 天河 主场 燥动 3d 足球 手游 真实度 中超 风云 动作 捕捉 数据 中超 球星 招牌动作 全球 领先 动作 捕捉 技术 精细 录制 比赛 让玩家 3d 足球 手游 策略性 球员 技能 阵型 战术 搭配 球员 花样 迭出 化学反应 足球 知识 战术 比赛 风格 中场 魔术师 锋线 尖刀 火花 3d 足球 手游 自由度 地域 喷子 中超 风云 独创 地域 青训营 家乡 发掘 球王 新疆 梅西 延边 内蒙 内马尔 3d 足球 手游 中超 风云 征途 时间轴 中国 足球 历史 中国 足球 恒大 亚冠 登顶 杀入 世界杯 激情 作者 互爱 北京 中文 内容 中超 风云 中超 胡莱 3d 国民 足球 手游 体育之窗 文化产业 监制 拱顶石 数百位 中超 球星 3d 视觉 比赛 特效 全球 领先 动作 捕捉 技术 中超 球星 动作 录制 让玩家 亲临 比赛 现场 中国 足球 爱好者 量身定制 足球 手游 网络游戏 足球 3d 体育 球类 网络游戏 足球 体育 3d 球类 360精品游戏
com.zaime.kuaidiyuan	快递员 购物 快递 生活 购物 快递 生活服务
